############
#   v    <K#
#          #
#          #
#   >     D#
#          #
#          #
#          #
#P        ^#
############
