########
#v    <#
#      #
#      #
#      #
#      #
#> P  ^#
########
