##############
#     >     K#
#            #
#            #
#            #
#        v  <#
#            #
#            #
#            #
#            #
#P ^        D#
##############
